_SSSSSSSSSSSSSSS
SSSSSSSSSSADS_S_
SSSSWWSSSSSSWSSS
_SS_SSSSSSSSSSSS
SSSSSSSSSSSSSSSS
SSSSSSSSSSSSADSS
WWW_SSS_________
________________
________________
________________
________________
________________
________________
________________
________________
________________