_SSSSSSSSSSSSSSS
SSSSSSSSSS__S_S_
SSSSSSSSSSSSSSSS
_SS_SSSSSSSSSSSS
SSSSSSSSSSSSSSSS
SSSSSSSSSSSS__SS
XSS_SSS_________
________________
________________
________________
________________
________________
________________
________________
________________
________________